1 1
GGGGGGGGGGGGGGG
GGGGGGGGGGGGGGG
GGGGGGGGGGGGGGG
GGGGGGGGGGGGGGG
GGGGGGGGGGGGGGG
GGGGGGGGGGGGGGG
GGGGGGGGGGGGGGG
GGGGGGGGGGGGGGG
GGGGGGGGGGGGGGG
GGGGGGGGGGGGGGG
.
XXXXXXXXXXXXXXX
X T           X
X      T      X
X             X
X   T      T  X
X             X
X     T       X
X           T X
X T           X
XXXXXXXXXXXXXXX