7 4
GGGGGGGGGGGGGGG
GGGGGGGGGGGGGGG
GGGGGGGGGGGGGGG
GGGGGGGGGGGGGGG
GGGGGGGGGGGGGGG
GGGSSSSSGGGGGGG
GSSSSSSGGGGGGGG
GGSSSSGGGGSSSSS
GGGGGGGGGSSSSSS
GGGGGGGGGGGSSSS
.
XXXXXXXXXXXXXXX
X T           X
X      T      X
X             X
X   T      T  X
X             X
X     T       X
X           T X
X T           X
XXXXXXXXXXXXXXX