XXXXXXXXXXXXXXXXXXXXXXXXXXXXXXXXXXXXXXXXXXXXXXXXXXXXXXXXXXXXXXXXXXXXXXXXXXXXXXXXXXXXXXXXXXXXXXXXXXXXXXXXXXXXXXXXXX
X                                                                                                                X
X                                                                                                                X
X                                                                                                                X
X                                                                                                                X
X                                                                                                                X
X      XXXXX       XXXXX       XXXXX       XXXXX       XXXXX       XXXXX       XXXXX       XXXXX       XXXXX     X
X      XXXXX       XXXXX       XXXXX       XXXXX       XXXXX       XXXXX       XXXXX       XXXXX       XXXXX     X
X      XXXXX       XXXXX       XXXXX       XXXXX       XXXXX       XXXXX       XXXXX       XXXXX       XXXXX     X
X      XXXXX       XXXXX       XXXXX       XXXXX       XXXXX       XXXXX       XXXXX       XXXXX       XXXXX     X
X      XXXXX       XXXXX       XXXXX       XXXXX       XXXXX       XXXXX       XXXXX       XXXXX       XXXXX     X
X                                                                                                                X
X                                                                                                                X
X                                                                                                                X
X                                                                                                                X
X                                                                                                                X
X      XXXXX       XXXXX       XXXXX       XXXXX       XXXXX       XXXXX       XXXXX       XXXXX       XXXXX     X
X      XXXXX       XXXXX       XXXXX       XXXXX       XXXXX       XXXXX       XXXXX       XXXXX       XXXXX     X
X      XXXXX       XXXXX       XXXXX       XXXXX       XXXXX       XXXXX       XXXXX       XXXXX       XXXXX     X
X      XXXXX       XXXXX       XXXXX       XXXXX       XXXXX       XXXXX       XXXXX       XXXXX       XXXXX     X
X      XXXXX       XXXXX       XXXXX       XXXXX       XXXXX       XXXXX       XXXXX       XXXXX       XXXXX     X
X                                                                                                                X
X                                                                                                                X
X                                                                                                                X
X                                                                                                                X
X                                                                                                                X
X      XXXXX       XXXXX       XXXXX       XXXXX       XXXXX       XXXXX       XXXXX       XXXXX       XXXXX     X
X      XXXXX       XXXXX       XXXXX       XXXXX       XXXXX       XXXXX       XXXXX       XXXXX       XXXXX     X
X      XXXXX       XXXXX       XXXXX       XXXXX       XXXXX       XXXXX       XXXXX       XXXXX       XXXXX     X
X      XXXXX       XXXXX       XXXXX       XXXXX       XXXXX       XXXXX       XXXXX       XXXXX       XXXXX     X
X      XXXXX       XXXXX       XXXXX       XXXXX       XXXXX       XXXXX       XXXXX       XXXXX       XXXXX     X
X                                                                                                                X
X                                                                                                                X
X                                                                                                                X
X                                                                                                                X
X                                                                                                                X
X      XXXXX       XXXXX       XXXXX       XXXXX       XXXXX       XXXXX       XXXXX       XXXXX       XXXXX     X
X      XXXXX       XXXXX       XXXXX       XXXXX       XXXXX       XXXXX       XXXXX       XXXXX       XXXXX     X
X      XXXXX       XXXXX       XXXXX       XXXXX       XXXXX       XXXXX       XXXXX       XXXXX       XXXXX     X
X      XXXXX       XXXXX       XXXXX       XXXXX       XXXXX       XXXXX       XXXXX       XXXXX       XXXXX     X
X      XXXXX       XXXXX       XXXXX       XXXXX       XXXXX       XXXXX       XXXXX       XXXXX       XXXXX     X
X                                                                                                                X
X                                                                                                                X
X                                                                                                                X
X                                                                                                                X
X                                                                                                                X
XXXXXXXXXXXXXXXXXXXXXXXXXXXXXXXXXXXXXXXXXXXXXXXXXXXXXXXXXXXXXXXXXXXXXXXXXXXXXXXXXXXXXXXXXXXXXXXXXXXXXXXXXXXXXXXXXX