[
  [ "X", "X", "X", "X", "X", "X", "X", "X", "X", "X", "X", "X", "X", "X", "X", "X", "X", "X", "X", "X", "X", "X", "X", "X", "X", "X", "X", "X", "X", "X", "X", "X", "X", "X", "X", "X", "X", "X" ],
  [ "X", "G", "G", "G", "G", "G", "G", "G", "G", "G", "G", "G", "G", "G", "G", "G", "G", "G", "G", "G", "G", "G", "G", "G", "G", "G", "G", "G", "G", "G", "G", "G", "G", "G", "G", "G", "G", "X" ],
  [ "X", "G", "X", "X", "X", "G", "G", "G", "G", "G", "G", "G", "G", "G", "G", "T", "G", "G", "G", "G", "G", "G", "G", "G", "G", "G", "G", "G", "G", "G", "X", "G", "G", "G", "G", "G", "G", "X" ],
  [ "X", "G", "X", "G", "G", "G", "G", "G", "X", "G", "G", "G", "G", "G", "G", "G", "G", "G", "G", "G", "G", "G", "G", "G", "G", "G", "G", "G", "G", "G", "G", "G", "G", "G", "G", "G", "G", "X" ],
  [ "X", "G", "G", "G", "G", "G", "G", "G", "G", "G", "G", "G", "G", "G", "G", "G", "G", "G", "G", "G", "G", "T", "G", "G", "G", "X", "G", "G", "G", "G", "G", "G", "G", "G", "G", "G", "G", "X" ],
  [ "X", "G", "G", "G", "G", "G", "G", "G", "G", "G", "G", "G", "X", "G", "G", "G", "G", "G", "G", "G", "G", "G", "G", "G", "G", "G", "G", "G", "G", "G", "G", "G", "G", "G", "G", "G", "G", "X" ],
  [ "X", "G", "G", "G", "G", "G", "G", "G", "G", "G", "G", "X", "G", "X", "G", "G", "G", "G", "G", "G", "G", "G", "G", "G", "G", "G", "G", "G", "G", "G", "G", "G", "G", "G", "G", "G", "G", "X" ],
  [ "X", "G", "G", "G", "G", "G", "G", "G", "T", "G", "G", "G", "X", "G", "G", "G", "G", "G", "G", "G", "G", "G", "G", "G", "G", "G", "G", "G", "G", "G", "G", "G", "G", "G", "G", "G", "G", "X" ],
  [ "X", "G", "G", "G", "G", "G", "G", "G", "G", "G", "G", "G", "G", "G", "G", "G", "G", "G", "G", "G", "G", "X", "G", "G", "G", "G", "G", "G", "G", "G", "G", "G", "G", "G", "G", "G", "G", "X" ],
  [ "X", "G", "G", "G", "T", "G", "T", "G", "G", "G", "G", "G", "G", "G", "G", "G", "G", "G", "G", "G", "G", "G", "G", "G", "G", "G", "G", "G", "G", "G", "G", "G", "G", "G", "G", "G", "G", "X" ],
  [ "X", "G", "G", "G", "G", "G", "G", "G", "G", "G", "G", "G", "G", "G", "G", "G", "G", "G", "G", "G", "G", "G", "G", "G", "G", "G", "G", "G", "G", "G", "G", "G", "G", "G", "G", "G", "G", "X" ],
  [ "X", "G", "G", "G", "G", "G", "G", "G", "G", "X", "G", "G", "G", "G", "G", "G", "G", "G", "G", "G", "G", "G", "G", "G", "G", "G", "G", "G", "G", "G", "G", "G", "G", "X", "G", "G", "G", "X" ],
  [ "X", "G", "G", "G", "G", "G", "G", "G", "G", "G", "G", "G", "G", "T", "G", "G", "G", "G", "G", "G", "G", "G", "G", "G", "G", "G", "G", "G", "G", "G", "G", "G", "G", "G", "G", "G", "G", "X" ],
  [ "X", "X", "X", "X", "X", "X", "X", "X", "X", "X", "X", "X", "X", "X", "X", "X", "X", "X", "X", "X", "X", "X", "X", "X", "X", "X", "X", "X", "X", "X", "X", "X", "X", "X", "X", "X", "X", "X" ]
]
